WWWWW
W00WW
W000W
WX0XW
WX0WW
W000W
W000W
WWWWW
1,1
2,2
3,2
4,2
