WWWWWWWW
WWWWW00W
WWWWW00W
W000W0XW
W000000W
WWWW00XW
WWWWWWWW
3,1
2,5
4,3
