WWWWWWWW
W00WW0XW
W00W00XW
W000000W
WW0000XW
WW00WWWW
WWWWWWWW
1,1
3,2
3,4
4,3

